%%%%%%%%%%%%
%  P .  .  %
%          %
%          %
%  .       %
%%%%%%%%%%%%